NO            textures/test/north.xpm                   
SO            textures/test/south.xpm
WE        textures/test/west.xpm
EA textures/test/east.xpm

F      139,108,66
C      135,206,235

1111111111111111111111111111111111111111111111
1E00000000000000000000000000000000000000000001
1111111111111111111111111111111111111111111111
