NO            textures/wolf/greystone.xpm                   
SO            textures/wolf/purplestone.xpm
WE        textures/wolf/bluestone.xpm
EA textures/wolf/mossy.xpm

F      139,108,66
C      135,206,235

        1111111111111111111111111
        1000000000110000000000001
        1011000001110000000000001
        10010000000D0000000000001
111111111011000001110000000000001
10000000001100000111D111111111111
11110111111111011100000010001
111101111111110111010100D0001
11000000110101011100000010001
10000000000000001100000010001
10000000000000001101010010001
11000001110101011111011110N0111
11110111 1110101 101111010001
11111111 1111111 111111111111
